11 11 
-1  -1  -1  -1  -1  -1  -1  -1  -1  -1  -1  
-1  -1  -1  -1  0  -1  0  -1  -1  -1  -1  
-1  -1  -1  0  0  -1  0  0  -1  -1  -1  
-1  -1  0  2  1  1  1  2  0  -1  -1  
-1  0  0  1  2  1  2  1  0  0  -1  
-1  -1  -1  1  1  2  1  1  -1  -1  -1  
-1  0  0  1  2  1  2  1  0  0  -1  
-1  -1  0  2  1  1  1  2  0  -1  -1  
-1  -1  -1  0  0  -1  0  0  -1  -1  -1  
-1  -1  -1  -1  0  -1  0  -1  -1  -1  -1  
-1  -1  -1  -1  -1  -1  -1  -1  -1  -1  -1  

8
4 2
2 4
4 8
2 6
8 4
8 6
6 8
6 2
