10 10 
-1  -1  -1  -1  -1  -1  -1  -1  -1  -1  
-1  0  0  2  0  0  2  0  0  -1  
-1  0  0  -1  0  0  -1  0  0  -1  
-1  -1  1  -1  -1  1  -1  -1  1  -1  
-1  0  0  2  1  0  -1  2  0  -1  
-1  0  2  -1  0  1  2  0  0  -1  
-1  1  -1  -1  1  -1  -1  1  -1  -1  
-1  0  0  -1  0  0  -1  0  0  -1  
-1  0  0  2  0  0  2  0  0  -1  
-1  -1  -1  -1  -1  -1  -1  -1  -1  -1  

6
1 1
1 4
1 7
8 2
8 5
8 8
