11 11 
-1  -1  -1  -1  -1  -1  -1  -1  -1  -1  -1  
-1  0  0  2  0  0  0  2  0  0  -1  
-1  0  -1  2  -1  0  -1  2  -1  0  -1  
-1  1  2  2  2  1  2  2  2  1  -1  
-1  0  -1  2  -1  0  -1  2  -1  0  -1  
-1  0  0  1  0  1  0  1  0  0  -1  
-1  0  -1  2  -1  0  -1  2  -1  0  -1  
-1  1  2  2  2  1  2  2  2  1  -1  
-1  0  -1  2  -1  0  -1  2  -1  0  -1  
-1  0  0  2  0  0  0  2  0  0  -1  
-1  -1  -1  -1  -1  -1  -1  -1  -1  -1  -1  

8
1 1
1 5
1 9
9 1
9 5
9 9
5 1
5 9
