20 20 
-1  -1  -1  -1  -1  -1  -1  -1  -1  -1  -1  -1  -1  -1  -1  -1  -1  -1  -1  -1  
-1  0  0  0  0  1  1  1  0  0  0  0  1  1  1  0  0  0  0  -1  
-1  0  -1  -1  -1  1  0  1  -1  -1  -1  -1  1  0  1  -1  -1  -1  0  -1  
-1  0  -1  0  0  0  0  0  1  0  0  1  0  0  0  0  0  -1  0  -1  
-1  0  -1  0  1  1  1  1  1  0  0  1  1  1  1  1  0  -1  0  -1  
-1  1  1  0  1  -1  -1  -1  1  1  1  1  -1  -1  -1  1  0  1  1  -1  
-1  1  0  0  1  -1  0  0  0  0  0  0  0  0  -1  1  0  0  1  -1  
-1  1  1  0  1  -1  0  2  2  2  2  2  2  0  -1  1  0  1  1  -1  
-1  0  -1  1  1  1  0  2  0  0  0  0  2  0  1  1  1  -1  0  -1  
-1  0  -1  0  0  1  0  2  0  2  2  0  2  0  1  0  0  -1  0  -1  
-1  0  -1  0  0  1  0  2  0  2  2  0  2  0  1  0  0  -1  0  -1  
-1  0  -1  1  1  1  0  2  0  0  0  0  2  0  1  1  1  -1  0  -1  
-1  1  1  0  1  -1  0  2  2  2  2  2  2  0  -1  1  0  1  1  -1  
-1  1  0  0  1  -1  0  0  0  0  0  0  0  0  -1  1  0  0  1  -1  
-1  1  1  0  1  -1  -1  -1  1  1  1  1  -1  -1  -1  1  0  1  1  -1  
-1  0  -1  0  1  1  1  1  1  0  0  1  1  1  1  1  0  -1  0  -1  
-1  0  -1  0  0  0  0  0  1  0  0  1  0  0  0  0  0  -1  0  -1  
-1  0  -1  -1  -1  1  0  1  -1  -1  -1  -1  1  0  1  -1  -1  -1  0  -1  
-1  0  0  0  0  1  1  1  0  0  0  0  1  1  1  0  0  0  0  -1  
-1  -1  -1  -1  -1  -1  -1  -1  -1  -1  -1  -1  -1  -1  -1  -1  -1  -1  -1  -1  

8
3 3
3 16
16 16
16 3
1 1
1 18
18 18
18 1
