15 15 
-1  -1  -1  -1  -1  -1  -1  -1  -1  -1  -1  -1  -1  -1  -1  
-1  1  1  0  0  1  1  0  1  1  0  0  0  0  -1  
-1  1  1  0  0  0  1  0  1  -1  -1  -1  0  0  -1  
-1  0  0  -1  0  0  0  -1  0  0  0  -1  0  0  -1  
-1  0  0  -1  0  0  0  -1  0  0  0  -1  0  0  -1  
-1  0  0  -1  -1  -1  1  0  1  0  0  0  1  1  -1  
-1  1  0  0  0  1  1  0  1  1  0  0  1  0  -1  
-1  2  -1  -1  -1  2  2  2  2  2  -1  -1  -1  2  -1  
-1  1  0  0  0  1  1  0  1  1  0  0  1  0  -1  
-1  0  0  -1  -1  -1  1  0  1  0  0  0  1  1  -1  
-1  0  0  -1  0  0  0  -1  0  0  0  -1  0  0  -1  
-1  0  0  -1  0  0  0  -1  0  0  0  -1  0  0  -1  
-1  1  1  0  0  0  1  0  1  -1  -1  -1  0  0  -1  
-1  1  1  0  0  1  1  0  1  1  0  0  0  0  -1  
-1  -1  -1  -1  -1  -1  -1  -1  -1  -1  -1  -1  -1  -1  -1  

8
4 4
3 10
11 10
10 4
5 1
2 12
12 12
9 1
