10 10 
-1  -1  -1  -1  -1  -1  -1  -1  -1  -1  
-1  0  2  0  1  1  0  2  0  -1  
-1  2  -1  0  2  2  0  -1  2  -1  
-1  0  0  0  1  1  0  0  0  -1  
-1  1  2  1  -1  -1  1  2  1  -1  
-1  1  2  1  -1  -1  1  2  1  -1  
-1  0  0  0  1  1  0  0  0  -1  
-1  2  -1  0  2  2  0  -1  2  -1  
-1  0  2  0  1  1  0  2  0  -1  
-1  -1  -1  -1  -1  -1  -1  -1  -1  -1  

4
3 3
3 6
6 6
6 3
