10 10 
-1  -1  -1  -1  -1  -1  -1  -1  -1  -1  
-1  0  0  0  2  2  0  0  0  -1  
-1  0  -1  0  0  0  0  -1  0  -1  
-1  0  -1  -1  1  1  -1  -1  0  -1  
-1  1  1  0  2  2  0  1  1  -1  
-1  1  1  0  2  2  0  1  1  -1  
-1  0  -1  -1  1  1  -1  -1  0  -1  
-1  0  -1  0  0  0  0  -1  0  -1  
-1  0  0  0  2  2  0  0  0  -1  
-1  -1  -1  -1  -1  -1  -1  -1  -1  -1  

4
1 2
1 7
8 7
8 2
